XXXXXXXXXXXXXXXXXXXXXXXXXXXXXXX
XSX       X   X               X
X X X XXX X X X XXXXXXXXXXX X X
X X X   X X X X       X   X X X
X X XXX X X XXXXX XXXXX X X XXX
X X   X X X       X     X X   X
X XXXXX X XXXXXXXXX XXXXX X X X
X     X X           X     X X X
XXXXX X XXXXXXXXXXXXX XXXXXXX X
X X   X     X X     X X     X X
X X XXXXXXX X X X XXX X X X X X
X X X       X   X X   X X X X X
X X X X XXXXXXXXX X XXXXX X X X
X X X X X         X X     X   X
X X XXX XXXXX XXXXX X XXXXXXX X
X X X   X     X     X X       X
X X X XXX XXX X XXXXX XXX XXXXX
X X   X   X   X X       X X   X
X XXXXX XXXXXXX XXXXXXX X XXX X
X                       X    GX
XXXXXXXXXXXXXXXXXXXXXXXXXXXXXXX