XXXXXXXXXXXXXXXXXXXXXXXXXXXXXXXXXXXXXXXXX
XX                                     XX
XX X XXXXX X X X X XXX X X X X XXXXXXX XX
XX   X     X   X X   X   X X   X   X   XX
XX XXX X XXXXXXX XXX XXX X XXXXX XXX XXXX
XX   X X XXX     X X   X X   XXX   X   XX
XXXX X X XXX XXXXX XXX X XXX XXX X XXX XX
XX   X X XXX X   X   X X X   XXX X   X XX
XX XXX XXXXX X XXX X X XXX XXXXX X XXX XX
XX   X   XXX X X   X X   X   XXX X     XX
XX XXXXX XXX X X XXX XXX XXX XXX XXXXXXXX
XX X   X XXX X     X   X     XXX X     XX
XX X X X XXX XXXXX XXX XXXXX XXX XXX X XX
XX X X   XXX   X   XSX   X   XXX X   X XX
XX X XXXXXXXXX XXXXX X XXX XXXXX X XXX XX
XX X     XXX   X     X   X X XXX   X   XX
XX XXXXX XXX X X XXXXX X X X XXXXXXX XXXX
XX X X   XXX X X   X   X X   XXX   X   XX
XX X X X XXX XXXXX X XXX XXX XXX X XXX XX
XX   X X XXX       X   X     XXX X   X XX
XXXXXX X XXXXXXXXXXXXXXXXXXXXXXX X XXX XX
XX   X X XXXXXXXXXXXXXXXXXXXXXXX X X   XX
XX X X X XXXXXXXXXXXXXXXXXXXXXXXXX X XXXX
XX X   X         X       X         X   XX
XX XXXXXXXXXXXXXXX XGXXX X XXXXX XXXXX XX
XX       X         X     X     X X     XX
XX XXXXX X XXXXXXXXX XXX XXXXX X X XXXXXX
XX X   X X X     X   X     X   X   X   XX
XX XXX X X X XXX X XXXXXXXXX XXXXXXX X XX
XX     X     X   X                   X XX
XXXXXXXXXXXXXXXXXXXXXXXXXXXXXXXXXXXXXXXXX
